-----#-----####
-----#---##----
######---------
-----####------
--------##-----
##--##---###---
######-##--###-
-------##--###-
---------------
######---------
