l-----I---tj---
J=====l--------
l-----t===>----
l---------I----
l----<>---t=>--
L====cj-<>--rff
l-------tj--tcc
l--------------
Lfffff>--------
######Lffffffff
