-----#---------
----------##---
---------------
---------------
-------------##
#-------------#
#-----#-----###
------#########
------------###
###############
