##############################
#--------#----------#--------#
#--------#----------#--------#
#--------#----------#--------#
#--------#----------#--------#
#--------#----------#--------#
#--------#----------#--------#
#--------#----------#--------#
#--------#----------#--------#
#--------#----------#--------#
#--------#----------#--------#
#--------#----------#--------#
#--------#----------#--------#
##############################
#----------------------------#
#----------------------------#
#----------------------------#
#----------------------------#
#----------------------------#
##############################